111111111111111-
331333313333133-
131311313113131-
131311313113131-
131311313113131-
131311313113131-
131311313113131-
133311333113331-
111111111111111